                              
     #############################  
 *   #*    ^ # #      #  *  # **        
  ^  #### # #  # #### # ### #### #  
^    #     ### #    #  * *# #  # #  
  *  # ####  * #### ## #### ## # #  
     # #    # #     #    *     #*#  
 * ^ #  *#  # # # ### ##### #### #  
     # # ## # # # # # ### # #  * #  
 *   # #  # #   #   #*    #   # ##  
     # ## #### #### ### ### ######  
 ^ * #    #  * #    # # **  #    #   
     #### # ## # #### # ### #### #  
 *   #     ### # *  #  *  # #  #*#      
     # ####  * #### ## #### ## #*#  
  *^ # #    # #     #     *    # #    
     #   #  # # # ### ##### #### #  
 ^   # # #### # # # # ### # #  * #   
   ^ # #  ^ #   #*  # *   #   # ##  
     # ###########################  #####